border_size=1
usage=map

Mm, Mm, Mm, Gs, Mm, Mm, Mm, Mm, Mm, Mm, Mm, Gs, Hh, Hh, Hh, Gs, Hh, Gs, Hh, Gs, Mm, Gg, Mm, Gg, Mm, Gg, Mm, Hh, Hh, Gg, Hh, Gg, Hh, Gs, Mm, Gg, Hh, Gg, Hh, Gs, Gs, Gs, Gs, Gs, Hh, Gs, Hh, Gg, Mm, Gg, Gs, Gg, Gs, Hh, Gs, Gg, Hh, Gg, Hh, Hh, Gs, Hh, Hh, Hh, Hh
Mm, Mm, Mm, Mm, Gs, Hh, Hh, Mm, Hh, Gs, Gs, Hh, Hh, Hh, Hh, Gs, Hh, Hh, Mm, Mm, Hh, Hh, Gs, Mm, Hh, Mm, Mm, Mm, Hh, Hh, Gs, Hh, Gs, Gs, Hh, Mm, Mm, Mm, Mm, Mm, Hh, Hh, Hh, Hh, Mm, Gs, Hh, Hh, Mm, Mm, Mm, Hh, Hh, Gs, Hh, Hh, Hh, Hh, Hh, Hh, Gd^Vo, Gs, Hh, Hh, Hh
Gs, Gs, Hh, Hh, Hh, Mm, Gs, Hh, Hh, Hh^Fmf, Hh, Gs, Gs, Hh, Hh, Hh, Gs, Mm, Mm, Mm, Hh, Hh, Hh, Hh, Hh, Mm, Hh, Gs, Mm, Gs, Gs, Hh, Hh, Gs, Gs, Hh, Hh, Mm, Mm, Mm, Rb, Hh^Vo, Hh, Hh, Gs, Gs, Gs, Gs, Hh, Gs, Gs, Hh, Mm, Gs, Gs, Hh, Mm, Hh, Gs, Gs, Mm, Gs, Mm, Mm, Mm
Gs, Hh, Mm, Mm, Mm, Mm, Hh, Gs, Hh, Gs, Gs, Gs, Gs, Gs, Gs, Gs, Hh, Hh, Hh, Hh, Gs, Hh, Gs, Hh, Hh^Vo, Hh, Hh, Mm, Mm, Mm, Gs, Hh, Gs, Hh, Gs, Hh, Hh, Mm, Uu^Em, Uu^Em, Mm, Gs, Gs, Hh, Gs, Hh, Gs, Gs, Gs, Hh, Gs, Gs, Gs, Hh, Mm, Mm, Gs, Gs, Mm, Mm, Hh, Hh, Mm, Hh, Mm
Gs, Mm, Hh, Gs, Hh, Gs, Hh, Hh, Gs, Hh, Gs, Gs, Hh^Fms, Hh, Hh^Fmf, Gs, Hh, Hh, Gs, Gs, Mm, Gs, Hh, Gs, Gs, Gs, Gs, Gs, Gs, Gs, Hh, Gs, Gs, Gs, Gs, Hh, Gs, Rb, Mm, Mm, Mm, Mm, Gs, Gs, Gs, Gs, Gd^Vo, Hh, Hh, Gs, Gs, Gs, Mm, Gs, Hh, Hh^Vo, Gs, Hh, Hh, Hh, Mm, Hh, Hh, Hh, Hh
Gs, Gs, Hh, Hh, Gd^Vo, Hh, Gs, Gs, Hh, Gs, Gs, Gs, Gs, Gs, Gs, Gs, Hh^Vo, Gs, Gs, Hh, Hh, Hh, 5 Ke, Hh, Gs, Gs, Gs, Gs, Gs, Gs, Gs, Hh, Gs, Hh, Gs, Gs, Hh^Vo, Gs, Mm, Hh, Hh, Mm, Hh, Gs, Gs, Gs, Gs, Gs, Gs, Gs, Hh, Hh, Gs, Hh, Gs, Gs, Gs, Gs, Hh, Hh, Hh, Hh, Hh^Vo, Hh, Gs
Gs, Hh, Gs, Gs, Gs, Hh^Fmf, Gs, Gs, Gs, Gs, Hh, Gs, Hh, Gs, Gs, Hh, Hh, Hh, Hh, Gs, Hh, Ce, Ce, Ce, Gs, Gs, Co, Gs, Gs, Gs, Gs, Gs, Gs, Gs, Hh, Hh, Hh, Gs, Rd, Mm, Mm, Gs, Gs, Gs, Gs, Gs, Hh, Gs, Gs, Gs, Hh, Gs, Gs, Gs, Gs, Gs, Gs, Gs, Gs, Gs, Gs, Hh, Gs, Hh, Gs
Gs, Hh, Gs, Gs, Mm, Hh, Gs, Gs, Gs, Gs, Hh, Hh, Gs, Gs, Hh^Fms, Gs, Gs, Gs, Gs, Gs, Hh^Fms, Hh, Gs, Gs, Gs, Co, 2 Ko, Co, Hh^Vo, Hh, Hh^Fms, Gs, Gs, Gs, Gs, Gs, Gs, Gs, Rd, Hh, Gs, Hh, Hh, Hh, Rd, Hh, Hh, Gs, Gs, Hh, Gs, Hh, Gs, Gs, Gs, Gs, Gs, Gs, Gs, Gs, Gs, Gs, Hh, Gs, Gs
Gs, Hh, Hh, Hh, Hh, Hh, Gs, Gs, Gs, Gs, Gs, Gs, Gs, Gs, Gs, Gs, Gs, Hh^Fms, Gs, Gs, Hh, Gs, Gs, Gs, Gs, Co, Co, Co, Gs, Hh, Mm, Rd, Gs, Hh, Gs, Hh, Gs, Gs, Gs, Rd, Gs, Hh, Gs, Gs, Hh, Gs, Gs, Gs, Gs, Gs, Hh, Gs, Gs, Gs, Gs, Gs, Ce, Ce, Ce, Gs, Gs, Gs, Gs, Hh, Gs
Gs, Gs, Gs, Gs, Mm, Mm, Gs, Gs, Gll^Fmf, Gs, Gs, Gs, Gs, Gs, Gs, Gs, Gs, Gs, Gs, Gs, Gs, Gs, Gs, Gs, Gs, Gs, Gs^Es, Gs, Gs, Gs, Gs, Mm, Mm, Gs, Hh^Fmf, Hh, Gs, Gll^Fmf, Hh, Gs, Gs, Gs, Gs, Hh, Hh, Gs, Gs, Gs, Hh^Fmf, Gs, Re^Vct, Gs, Gs, Gs, Gs, Gs, Ce, 1 Ke, Ce, Gs, Gs, Gs, Hh, Gs, Gs
Gs, Gs, Gs, Mm, Gs, Gs, Gs, Gs^Fms, Gs^Fms, Gll, Gs, Gs, Gs, Gs, Gs, Gs, Gs, Gs, Gs, Gs, Gs^Eff, Gs, Gg, Gg, Gg, Gs, Gs, Gs, Gs, Gs, Hh, Hh, Hh, Hh, Rd, Gs, Hh, Hh^Fmf, Hh, Gs, Gs, Gs, Hh, Gs, Gs, Gs, Gs, Hh, Gs^Fms, Hh, Hh^Fmf, Gs, Gs, Gs, Gs, Gs, Gs, Ce, Gs, Gs, Gs, Gs, Re^Vct, Gs, Gs
Gs, Gs, Gs, Gs, Gll^Fmf, Gs, Gs, Gs, Gs, Gs, Gs, Gs, Gs, Gs, Gs^Fmf, Gs, Gs, Gs, Gs^Eff, Gs^Eff, Rb, Gs^Eff, Gg^Eff, Gg, Gg, Gs, Gs, Gs, Gs, Hh^Fms, Gs^Fmf, Hh, Gs^Fmf, Hh, Gs, Gs, Gs, Hh, Gs, Gs, Hh, Gs, Gs, Hh, Gs, Hh, Gs, Gs, Gs, Gs, Gs, Gs, Gs, Gs, Gs, Gs, Gs, Gs, Gs, Gs, Gs, Gs, Gs, Gs, Gs
Gs, Gs, Gs, Gs^Fms, Gs, Gs, Gs, Gs, Gs, Gs, Gs, Gs, Gll, Gs^Fms, Gs, Gs, Gs, Gg, Gg, Rb, Rb, Rb, Rb, Gg^Eff, Gs^Eff, Gg, Gs, Gs, Gs, Gs, Gs, Gs, Gs, Gs, Gs, Gs^Es, Gs, Gs, Hh, Gs, Gs, Gs, Hh, Gs, Hh^Fms, Gs, Hh, Gs, Gs, Gs^Es, Gs, Gs, Gs, Gs, Gs, Gs, Hh, Gs, Gs, Re^Vct, Gs, Gs, Hh, Hh, Hh
Gs, Gs, Gs^Fms, Gs, Gs, Gs, Gs, Gs, Gs, Gs, Gs, Gs, Gs, Gs, Gs, Gs, Gs, Gs, Gs, Gs^Eff, Gg^Eff, Rb, Gs^Vhhr, Gg^Eff, Gs, Gs, Gs, Gg, Gs^Es, Gs, Gs, Gs, Gs, Gs, Hh^Fms, Gs, Gs, Hh^Fms, Hh, Gs, Gs, Gs, Gs, Hh^Fmf, Gs, Gs, Gs, Gs, Gs, Gs, Gs, Gs, Gs, Gs, Gs, Gs, Gs, Hh, Gg, Hh, Hh, Hh, Gg, Hh, Hh
Gs, Gs, Gll^Fmf, Gll^Fmf, Gs, Gs, Hh^Vhh, Gs, Gs, Gs, Gs, Gs, Gs, Gs, Gs, Gs, Gs, Gs, Gs, Wwg, Wwg, Gg, Gg, Gs, Gs, Gs, Gg, Gs, Gs, Gs, Gs, Hh, Hh, Gs, Gs, Gs, Gs, Gs, Gs, Gs, Gs, Gs^Es, Gs, Gs, Gs, Gg, Gs, Gs, Gs, Gg, Chr, Gs, Gs, Gs, Gs, Gs, Gs, Gs, Hh, Gg, Gg, Gg, Hh, Hh, Hh
Gs, Gs, Gs, Gs, Gs, Hh, Gs, Gs, Gs, Gs, Gs, Gs, Gs, Gs, Gs, Gs, Gs, Gs, Gs, Wwg, Gs, Gs, Gs, Gs^Fms, Gs, Gs, Gs, Gs, Gs, Gs, Gs, Hh, Gg, Gs, Gg^Es, Gs, Gs, Gs, Re, Hh^Fms, Re, Hh^Fmf, Re, Rd, Re, Rd, Re, Gs, Kh, Khr, Gs^Vhhr, Gs, Gg, Gs, Gs, Gs, Gs, Gs, Gg, Hh, Gs, Hh, Hh, Hh, Hh
Gs, Gs^Fms, Gs, Gs, Gs, Hh, Gs, Gs, Gs, Gs, Gs, Gs, Gs, Gs, Gs, Gs, Gs, Gs, Gs, Gll^Fms, Gs, Gs, Hh, Gs, Re, Gs, Gs, Gs, Gs, Gs, Hh^Fmf, Gs, Wwg, Gs, Gs, Gs, Rd, Re, Re, Re, Re, Re, Re, Re, Gg, Re, Re, Re, Re, Gg, Gs, Gg, Gs, Gs, Gs, Gg, Gg, Gs, Gs, Hh, Gs, Hh, Hh, Hh, Hh
Gs, Gs, Hh, Hh, Gs, Gs, Gs, Gs, Gs, Gs, Gs, Gs, Gs, Gs, Gs, Gs, Gs, Gs, Gs, Gs, Re, Rd, Re, Rd, Re, Re, Re, Gs, Re, Hh^Fms, Hh^Fms, Hh^Fms, Gs^Vh, Gs^Vl, Hh^Fmf, Hh, Re, Re, Gs, Gs, Gs, Gs, Gs, Gs, Gs, Gs, Kh, Re, Re, Re, Re, Gg, Gs, Gg, Gs, Gs, Gs, Gs, Gs, Hh, Hh^Vhhr, Hh, Gs, Hh, Hh
Gs, Gs, Gs, Gs, Gs, Gs, Gs, Gs, Gs, Gs, Gs, Gs, Gs, Gs, Gs, Gs, Gs, Gs, Re, Re, Re, Re, Hh^Fms, Re, Gg, Re, Re, Re, Re, Re, Re, Re, Re, Re, Re, Re, Rd, Rd, Gs, Gs, Gs, Gs, Hh^Fmf, Gs, Gs, Gs, Khr, Gg, Gs, Re, Rd, Re, Re, Gs, Gg, Gs, Gs, Gs, Gs, Gs, Gs, Gs, Gs, Gs, Gs
Gs, Hh, Gs, Gs, Gs, Gs, Gs, Gg, Gs^Eff, Gs, Gs, Gs, Gs, Gs, Gs, Gs, Re, Re, Re, Re, Gg, Gg, Gg, Gg, Gg, Gs, Gg, Gs, Gll^Fmf, Gs^Fms, Gs, Re, Re, Re, Gll^Fmf, Rd, Gs, Gs, Gs, Gs, Gll, Gll, Gs, Gs, Gs, Gg, Chr, Gg^Vhhr, Gs, Gs, Gs, Rd, Rd, Re, Re, Gg, Gs, Gg, Gg, Gs, Gs, Gs, Gs, Gs, Gs
Gs, Gs, Gs, Gs, Gs, Gs, Gs^Eff, Gs^Eff, Gg, Gs^Eff, Ce, Ce, Ce^Vl, 4 Ket, Re^Eff, Re, Re, Re, Gg, Gg, Gs, Gs, Gs, Gg, Gg, Gg, Gll^Fmf, Gs, Gs, Gs, Gll^Fmf, Gs, Gs, Gs, Gs, Gs, Gll^Fmf, Gs, Gs, Gs, Hh^Fds, Mm, Gs, Gs, Gs, Gs, Gg, Gs, Hh, Mm, Hh, Gs, Gs, Re, Rd, Re, Re, Gs, Gs, Gs, Hh, Gs, Hh^Fmf, Gs, Gs
Gs, Gs, Gs, Gs, Gs, Gs^Eff, Gs^Eff, Gs, Gs, Wwg, Ce, Ce, Re, Re, Re^Eff, Re^Eff, Gg, Gs, Gg, Gg, Gs, Gs, Gs, Gs, Gs, Gs, Gs^Fds, Gs, Gs^Fms, Hh, Gs, Gll^Fmf, Gll, Gs, Gll, Hh^Fms, Hh^Fms, Hh, Gs, Gs, Gs, Hh, Gs, Gll^Fmf, Hh, Gs, Gs, Gs, Gs, Hh^Fmf, Gs, Gs, Gs, Gs, Gs, Rd, Re, Rd, Re, Re, Rd, Re, Re, Re, Re
Gs, Gs, Hh^Vhh, Gs, Gs, Gs, Gs, Gs^Eff, Gs^Eff, Gs^Eff, Gs^Vl, Ket, Re, Ket, Gg, Gg, Gg, Gs, Gs, Gll^Fmf, Gg, Gg, Gs, Gg, Gs, Hh^Fms, Gs^Fds, Gll^Fmf, Gs^Fds, Hh^Fms, Gll, Gll, Gs^Fds, Gll^Fmf, Gs^Fds, Gg^Ve, Gs^Fds, Gll, Gs, Gs, Gs, Gs, Hh, Hh, Mm, Hh^Fds, Rb, Hh, Gs, Gs, Gll, Gll, Gs, Hh^Fmf, Hh, Gs, Gs, Re, Hh, Rd, Gs, Re, Gs, Rd, Gs
Gs, Gs, Gs, Hh, Gs, Gs, Gs, Gs, Gs, Gs, Gs, Re, Re, Gs, Gs, Gs, Gs, Gs, Gs, Gg, Gs, Gg, Gg, Gs, Gg, Gg, Gs, Gll, Gs, Gs, Gs^Fds, Gll^Fmf, Gll, Hh^Fmf, Gs^Fds, Gll^Fmf, Gs^Fds, Gll^Fmf, Gll^Fmf, Hh^Fms, Hh, Gs, Gs^Fmf, Hh^Fmf, Uu, Uu, Mm, Gll, Gll^Fmf, Gs, Gs, Gll, Gs, Gs, Gs, Gs, Gs, Gs, Gs, Gs, Gs, Gs, Gs, Gs, Gs
Gs, Gs, Gs, Gs, Gs, Gs, Gs, Gs, Gs, Gs, Gs, Re, Re, Gs, Gs, Gs, Gs, Gs, Gg, Gg, Gg, Gs, Gs^Ve, Gg, Gs, Gs, Gs, Gs, Gs, Gs, Gs, Gs^Fds, Gs, Gs, Gs, Gs^Fds, Gs, Hh, Gs, Gs, Hh^Fms, Gs, Gs, Rb, Rb^Ve, Mm, Mm, Hh, Gs^Fmf, Gll, Gs^Fms, Gll^Fmf, Gll^Fmf, Gs, Gs, Gs, Gs, Gs, Gs, Gs, Gs, Hh^Fmf, Gs, Gs, Gs
Gs, Gs, Gg, Gs, Gs, Gs, Gs, Gs, Gs, Gs, Gs, Re, Re, Gs, Gs, Gs, Gs, Gg, Gs, Gg, Gs, Gg, Gs^Fms, Gs^Fms, Gs^Fms, Gs^Fms, Gs^Fms, Gll, Gs^Fds, Gll, Gll, Gs, Gll^Fmf, Gs, Cv, Cv, Cv, Gs, Gll, Hh, Hh, Hh^Fms, Gs, Gs, Gll^Fmf, Hh, Hh, Gll, Gll, Gs^Fms, Gs, Gs^Fms, Gll, Gll, Hh^Fms, Gs^Fmf, Gs, Gg^Ve, Gs^Fds, Gs, Gs, Gs, Gs, Gs, Gs
Gs, Gs, Gs, Gs, Gs, Gg, Gs, Gg, Gs, Gs, Gs, Re, Re, Gs, Gg, Gs, Gs, Gs, Gs^Fms, Gll^Fmf, Gs, Gs, Gs, Hh^Fmf, Gll^Fmf, Gs, Gll, Gll^Fmf, Gll, Gs^Fms, Gs, Gs^Fds, Gll^Fmf, Gs, Cv, 3 Kv, Cv, Gll, Gs^Fds, Gll^Fmf, Gll^Fmf, Gs, Gs, Gll^Fmf, Gs^Fds, Hh, Gs^Fmf, Gll, Gll^Fmf, Gll^Fmf, Gll^Fds, Gs, Hh^Fms, Gll, Gll, Hh^Fms, Gs, Gs^Fmf, Gs^Fds, Gs, Gll^Fmf, Gs, Gs^Fms, Gs, Gs
Gs, Gs, Gs, Gs, Gs, Gs, Gg, Gs, Gs, Gs, Gs, Re, Re, Gg, Gs, Gs, Gs, Gs, Gs, Gs, Hh, Gs, Gs^Fms, Gs, Gll, Gs^Fms, Gs^Fms, Gll^Fmf, Gs^Fms, Gs, Gs, Gs^Fds, Gg, Gs, Gs, Cv, Gs^Fms, Gll^Fmf, Gs^Fds, Gs^Fds, Gs, Gll, Gll, Gs^Fds, Gll^Fmf, Gll, Gs, Gs, Gll, Gll^Fmf, Hh^Fms, Gs, Gs, Gs, Gs, Gg^Fmf, Gg, Gs, Gs, Gll, Gs, Gll, Gll, Gll^Fmf, Gs
Gs, Gs, Gs, Gs, Gg, Gg, Gs, Gs, Gs, Gs, Rd, Re, Re, Gs, Gs, Gs, Gg, Gg, Gs, Gg, Gs, Gg, Gs^Fms, Gs, Gs^Fds, Gs^Fms, Hh^Fds, Gll^Fmf, Gs^Fms, Gg^Fet, Gs^Fms, Gll^Fmf, Gs, Gs, Gg, Gs, Gs, Gs^Fds, Hh, Hh^Fms, Gs, Gll, Gll^Fmf, Gs^Fms, Gll^Fmf, Gs^Fds, Hh^Fms, Gg^Fmf, Gll^Fmf, Gg^Fet, Gs^Fds, Gs^Fms, Gll, Gll, Gll^Fmf, Gg, Gs, Gll, Gs^Fmf, Gg, Gll^Fmf, Gs^Fms, Gs^Fms, Gs, Gs
Gs, Gs, Gg, Gs, Gs, Gs, Gs^Vl, Gs, Re, Rd, Re, Re, Gs, Gs, Gs, Gs^Fms, Gg, Gll^Fmf, Gll^Fmf, Gg, Gll^Fmf, Gll^Fmf, Gs, Gs, Gs^Fds, Gll^Fmf, Hh, Gll^Fmf, Gg, Gs^Fms, Gs^Fms, Hh^Fmf, Hh^Fmf, Gs, Gll, Gs^Fms, Gs^Fms, Gll^Fmf, Gs^Fms, Hh^Fms, Gs, Gs, Gll^Fmf, Gs^Fds, Hh^Fms, Gs^Fds, Hh^Fms, Gs, Gs^Fms, Gll^Fmf, Gg, Gs^Fms, Gs, Gs^Fmf, Gs^Fds, Gs^Fds, Gs, Gll, Gll, Gs^Fms, Gs^Fms, Gll, Gll, Gs, Gs
Gs, Gg, Gs, Gs, Gs, Gs, Re, Re, Re, Re, Gs, Gs, Gs, Gs, Gs, Gll^Fmf, Gll^Fmf, Gg^Ve, Gs, Gs, Gs^Fms, Hh^Fmf, Gs^Fms, Gs, Gll, Gll^Fmf, Gs^Fms, Gll, Gs^Fms, Gll^Fmf, Gll^Fmf, Gll^Fmf, Gll^Fmf, Gs^Fds, Gs, Gs^Fms, Gll^Fmf, Gs^Fms, Gs^Fds, Gg^Ve, Gs, Gs, Gs^Fds, Gll^Fmf, Gll, Gll, Gll, Gs^Fmf, Gll^Fms, Gll, Gg, Gll, Gll^Fms, Gll, Gll, Hh^Fms, Gs, Gs, Gg, Gll, Gll^Fmf, Gll^Fmf, Gs, Gll, Gs
Gs, Gs, Gs, Gs, Re, Re, Re, Re, Gs, Gs, Gs, Gs, Gs, Gg, Gs^Fms, Gs^Fms, Gs^Fms, Gs, Gs^Fms, Gs, Gg, Gs, Gs, Gll, Gll^Fmf, Gs^Fms, Gll, Gs^Fms, Gll, Gs^Fms, Gg^Ve, Gs^Fds, Gs^Fms, Gs^Fds, Gs, Gs, Gs, Gg^Fet, Gll, Gs, Gll, Gs^Fms, Gs^Fds, Gs^Fms, Gll, Gll^Fmf, Gll^Fmf, Gll, Gg^Ve, Gs, Gll^Fmf, Gll, Gs^Fds, Gll^Fmf, Gs^Fms, Gs^Fds, Gll, Gll, Gll, Gs^Fms, Gs^Fms, Gg^Fet, Gll, Gg, Gs
Gs, Gs, Re, Re, Re, Re, Gs, Gs, Gg, Gg, Gs, Gll^Fmf, Gll^Fmf, Gll^Fmf, Gs, Gs^Fms, Gll^Fmf, Gs, Gs^Fms, Gll^Fmf, Gll^Fmf, Gll, Gll^Fmf, Gs^Fms, Gg, Gs^Fms, Gll^Fmf, Gs^Fds, Gs, Gll^Fmf, Gs^Fds, Gg, Gs, Gs, Gs, Gll, Gs, Gll, Gll^Fmf, Gs^Fms, Gs^Fds, Gll^Fmf, Gll, Gll^Fmf, Gll^Fmf, Gll^Fmf, Gs^Fmf, Gll, Gs^Fms, Gll^Fmf, Gll, Gs, Gll, Gs^Fds, Gs^Fms, Gll^Fmf, Gs^Fms, Gll, Gll^Fmf, Gll, Gs^Fds, Gll, Gs^Fds, Gll^Fmf, Gs
Gs, Re, Re, Re, Gs, Gs, Gs, Gg, Gll^Fmf, Gll^Fmf, Gll^Fmf, Gs^Fds, Gs^Fds, Gs^Fds, Gs^Fds, Gs, Gs, Gs, Gs, Gs, Gs, Gll, Gll^Fmf, Gs^Fds, Gll, Gs^Fds, Gll, Gs, Gs, Gll^Fmf, Gs^Fds, Gs^Fds, Gs, Gg, Gs, Gs, Gll^Fmf, Gll^Fmf, Gs^Fds, Gll^Fmf, Gg^Fet, Gs^Fms, Gll^Fmf, Gs, Gll, Gll, Gll, Gll, Gll, Gll, Gll^Fmf, Gg^Fet, Gs^Fds, Gll^Fmf, Gll^Fmf, Gll^Fmf, Gs^Fms, Gs^Fds, Gll^Fmf, Gs^Fds, Gll^Fmf, Gll^Fmf, Gs^Fms, Gll^Fmf, Gs
Gs, Re, Gs, Gs, Gs, Gs, Gs, Gs, Gll^Fmf, Gs^Fds, Gs, Gs, Gs, Gs, Gs, Gs, Gs, Gs, Gs, Gs, Gs, Gs, Gs, Gs, Gs, Gg, Gs, Gg, Gs, Gs^Fds, Gs, Gll, Gs, Gs, Gs, Gs, Gs, Gs^Fds, Gs, Gs, Gs, Gs, Gs, Gs, Gs, Gll, Gs, Gs, Gs, Gs^Fms, Gs, Gll^Fmf, Gs, Gs^Fms, Gs, Gs, Gs, Gll^Fmf, Gs, Gll^Fmf, Gs, Gs, Gs, Gll^Fmf, Gs
