border_size=1
usage=map

Mm, Gs, Mm, Mm, Mm, Mm, Mm, Mm, Mm, Mm, Mm, Mm, Mm, Mm, Mm, Mm, Mm, Mm, Mm, Mm, Mm, Mm, Mm, Gs, Hh, Gs, Gs
Mm, Mm, Aa, Mm, Mm, Mm, Mm, Hh, Mm, Gd, Gd, Aa, Mm, Mm, Mm, Gd, Ai, Aa^Fda, Hh, Aa, Hh, Mm, Mm, Hh, Mm, Hh, Hh
Mm, Mm, Gd, Aa, Hh, Mm, Mm, Mm, Hh, Hh, Mm, Mm, Mm, Mm, Mm, Mm, Mm, Ai, Mm, Hh, Hh, Aa^Fda, Aa^Voa, Mm, Mm, Mm, Mm
Mm, Mm, Gd, Hh, Aa, Mm, Hh, Mm, Mm, Mm, Mm, Mm, Ai, Mm, Ai, Mm, Mm, Mm, Mm, Aa^Fda, Gd, Hh, Mm, Ha, Mm, Mm, Mm
Gd, Hh, Hh, Hh, Gd, Mm, Gd, Mm, Aa, Mm, Mm, Aa^Voa, Hh, Wog, Wwf^Es, Aa^Fda, Ai, Mm, Gd, Gd, Co, Aa, Mm, Aa^Fda, Aa^Fda, Mm, Mm
Hh, Gd, Hh, Hh, Hh, Hh, Hh, Coa, Mm, Aa, Mm, Gs, Wwg, Wwg, Mm, Ai, Hh, Aa^Fma, Gs, Aa, Coa, Ko, Coa, Aa^Fda, Mm, Mm, Mm
Hh, Hh, Hh, Gd, Aa, Mm, Coa, Hh, Gd, Hh, Gd, Gs, Wwg, Gs, Aa^Fma, Hh, Gd, Gs, Gll^Fdw, Gs, Gs, Coa, Gd, Aa, Coa, Mm, Mm
Gd, Gd, Gd, Aa, Aa, Cea, Hh, Mm, Gs, Gs, Wwf^Es, Wwg, Gs, Gs, Hh, Gs, Gll^Fdw, Gs, Gs, Gs, Gs, Gs, Aa^Fma, Aa, Cea, Hh, Mm
Gs, Gd, Hh, Gd, Aa, Ce, Gs, Gs^Vc, Hh, Gs, Wwf^Es, Gs, Rd, Gd^Vo, Hh, Gll^Fdw, Hh, Gs, Gll^Fdw, Gs, Gll^Fdw, Gs, Gs, Aa^Voa, Cea, Hh, Mm
Rb, Gs, Re, Gd, Gs^Dr, Coa, Gd, Gs, Gd, Gd, Rb, Rb, Rb, Rd, Gs, Gs, Rd, Gs, Re, Gs, Re, Gs, Gs, Sm, Mm, Mm, Mm
Re, Re, Re, Re, Re, Re, Gs, Hh, Gs, Gd, Rd, Sm, Wwf^Es, Rd, Gs, Re, Re, Re, Re, Re, Rd, Gd^Vo, Gs, Mm, Gd, Gs, Mm
Re, Re, Re, Re, Re, Re, Re, Re, Re, Rd, Gs, Rd, Gs, Wwg, Rd, Hhd, Re, Re^Edb, Re, Rd, Rd^Edb, Rd, Rd, Re, Re, Re, Re
Gs, Gs, Gd, Gd, Gs^Dr, Re, Rb, Re, Re, Re, Re, Gs^Vc, Rd, Wwf^Es, Rb, Rd, Rd, Rd, Ds^Ecf, Re, Rd, Rd^Edb, Rd, Re, Re, Re, Gs
Gs, Gs, Gd, Gd, Re, Ce, Gs, Gll^Fdw, Gs, Re, Re, Re, Rd, Rb, Rb, Rd, Ds^Ecf, Rd, Ds^Es, Rd, Ds^Ecf, Rd, Gd^Vo, Co, Re, Re, Gs
Gs, Gs, Gd, Gd, Re, Ce, Ce, Gs, Gll^Fdw, Re, Re, Re, Re, Re, Wwg, Rd, Rb, Rd^Es, Rd^Edb, Rd, Rd, Ds^Edb, Rd, Ce, Gd, Gs, Gs
Gs, Gs, Hh, Gd, Gd, Ce, Ce, Ce, Gs, Rd, Rd, Gs, Rb, Wwf^Es, Rd, Ds^Edt, Ds^Ecf, Rd^Edb, Rd, Rd^Edb, Ds^Ecf, Ds^Edb, Hhd, Co, Gd, Gs, Gd
Gs, Gs, Gd, Gd, Gd, Ke, Ce, Ce, Gd, Gd, Gd, Gs, Rb, Sm, Gd^Vo, Gd, Rd^Edt, Rd, Ds^Ecf, Rd^Edb, Rd, Rd, Hhd, Md, Gd, Gd, Gs
Gs, Gs, Gd, Gd, Gd, Re, Gs^Vc, Ce, Ce, Gd, Gs^Vc, Gd, Ce, Wwg, Wwf^Es, Rd, Rd, Ds, Ds, Rd, Rd, Rd, Co, Ce, Gs, Gs, Gs
Gs, Gs, Gs, Gd, Hh, Re, Gd, Gd, Hh, Ce, Hh, Co, Gd, Co, Wwg, Hhd, Gll^Fdw, Gs, Ce, Co, Gd, Rb, Rb^Eff, Gs, Gs, Gs, Gs
Gs, Gs, Gs, Gs, Gs, Gs, Gs, Gd, Gd, Gd, Gll^Fdw, Gd, Hh, Gd, Gll^Fdw, Wwf^Es, Wwg, Co, Gd, Gd, Hhd, Hhd^Eff, Rb, Gs, Gs, Gd, Gs
Gs, Gs, Gs, Gs, Gs, Gs, Gs, Gll^Fdw, Gs, Re, Gd, Rb, Rb, Gs, Gll^Fdw, Gd^Eff, Rb^Eff, Sm, Rb, Gs, Gs, Hh, Gs, Rb, Rb, Gs, Gs
Gs, Gs, Gs, Gs, Gs, Gs, Gs, Gs, Gs, Gs, Gs, Gs, Gs, Gs, Hh, Hh, Gs, Sm, Wwf^Es, Rb, Gs, Gs, Gs, Gs, Mm, Rb, Gs
Gs, Gs, Gg, Gs, Gs^Fds, Gs, Gs, Gs, Gs, Gs, Gs, Gs, Gs, Gs, Gs, Gs, Hh, Gs, Rb, Wwg, Hh, Gs, Gs, Mm, Mm, Mm, Hh
Gs, Gs, Gs, Gll^Fmw, Gs^Fds, Gs, Gs, Gs, Gg, Gs, Gs, Gs, Gg, Gs, Gs, Gs, Gs, Hh, Rb, Sm, Hh, Mm, Gs, Aa^Fma, Aa^Fma, Hh, Gg
Gs, Gs, Gs, Gs, Gs, Gs, Gs, Gg, Gs, Gs, Gll^Fmw, Gs, Gs, Gs, Gs, Gs, Gs, Gg, Gs^Eff, Wwf^Es, Wwg, Gs, Gs, Gs, Gs, Hh, Hh
Gs, Gs, Gg, Gs, Gs, Gs, Gs^Fds, Gll^Fmw, Gg, Gs, Gg, Gg, Gg, Gs, Gs, Gs, Gg^Eff, Gs^Eff, Gs^Vh, Gg, Hh, Wwg, Rb, Hh, Gs, Hh, Hh
Gs^Fds, Gll^Fmw, Gs^Fds, Gs^Fds, Gs, Gs, Gs, Gs^Fds, Gg, Gs, Gs, Gs, Gg^Es, Gg^Es, Gg^Eff, Gg^Eff, Gs, Gg, Gg, Gs, Gs, Rb, Rb, Rb, Hh, Hh, Hh
Gg, Gs^Fds, Hh, Gs, Gs, Gs, Gs^Eff, Gg, Gs^Eff, Gg^Eff, Gg^Eff, Gs, Hh^Vhh, Gg^Eff, Gg^Eff, Gg, Gg, Gs, Gg, Gg, Gg, Gg, Gg, Wwg, Wwf^Es, Hh, Hh
Gs, Gs^Fds, Gs, Gs, Hh, Gs^Eff, Gs, Gs^Eff, Gg, Gg, Gs^Fds, Gg^Eff, Gg, Hh, Gg^Es, Gs^Eff, Gs, Gs, Hh, Gg, Gg, Gs, Gg, Rb, Rb, Gs, Gs
Gg, Gs, Gs, Hh, Gs, Gs, Gg, Gs, Gg, Gs^Fds, Gs^Fds, Gs, Rb^Gvs, Rb^Gvs, Rb^Gvs, Gg^Es, Gs^Eff, Gs^Eff, Gs, Hh, Gg, Gg, Gg, Wwf^Es, Rb, Gs, Gs
Gg, Gs, Gs, Gg, Gs, Gs, Gs, Gs, Gs, Gs, Gs^Fds, Gs, Gg, Rb^Gvs, Rb^Gvs, Rb^Gvs, Gg, Gs, Wwg, Rb, Wwg, Rb, Wwf^Es, Wwg, Gg, Gs, Gs
Gs^Fds, Gs^Fds, Gg, Gs, Gs, Gs, Rb^Gvs, Rb^Gvs, Rb^Gvs, Gg, Gg, Gs, Rb^Gvs, Gs, Gs, Gg, Wwf^Es, Wwf^Es, Gg, Rb, Gg, Rb, Gg, Gg, Gg, Gs^Vl, Gs
Gs^Fds, Gg, Gs^Fds, Gg, Gg, Gs, Gs, Rb^Gvs, Gs, Gs^Fds, Gs^Fds, Rb^Gvs, Rb^Gvs, Rb^Gvs, Gs, Gg, Sm, Sm, Ce, Ce, Ce, Gg, Rb^Gvs, Rb^Gvs, Rb^Gvs, Hh, Hh
Gs^Fds, Gs^Fds, Gg, Gs, Rb^Gvs, Rb^Gvs, Rb^Gvs, Gg, Gg, Gs^Fds, Gs^Vh, Gs, Gg, Gs, Hh, Gs, Wwg, Rb, Ce, Kh, Ce, Gg, Gg, Rb^Gvs, Gs^Fds, Gg, Gg
Gs^Fds, Gs^Fds, Gs^Fds, Gs^Fds, Gg, Rb^Gvs, Rb^Gvs, Rb^Gvs, Gg, Gg, Gs, Gs, Gs, Gs^Fds, Hh, Gs^Fds, Wwf^Es, Rp, Rp, Ce, Rp, Rp, Gg, Gg, Rb^Gvs, Gg, Gg
Gg, Gs^Fds, Hh, Hh, Gs, Gs, Gg, Gg, Rb^Gvs, Rb^Gvs, Rb^Gvs, Gg, Gg, Gg, Gg, Gg, Rb, Rb, Rb, Rp, Rp, Rr^Vhc, Rb^Gvs, Rb^Gvs, Rb^Gvs, Rb^Gvs, Gg
Gg, Gg, Gg, Gs, Gs, Gs, Gs, Gg, Gg, Rb^Gvs, Gg, Gg, Gs, Gg, Gg, Gg^Efm, Gg, Rb^Bw/, Wwg, Rr^Vhc, Gg, Gg, Gg, Rb^Gvs, Gs^Fds, Gs^Fds, Gg
Gg, Gg, Gs, Gs, Gg, Gs, Gg, Gg, Gg, Gg, Rb^Gvs, Rb^Gvs, Rb^Gvs, Gg, Gs^Fds, Gg, Gg, Gg, Rb, Wwf, Gg, Gg, Gg, Gg, Gg, Gg, Gg
