border_size=1
usage=map

Rd, Rd, Rd, Rd, Rd, Rd, Rd, Rd, Rd, Rd, Rd, Rd, Rd, Rd, Rd, Rd, Rd, Rd, Re, Re, Re, Rd, Ww, Gg, Gs^Fds, Gs^Fds, Gs^Fds, Gs^Fds, Gs^Fds, Gs^Fds, Gs^Fds, Gs^Fds
Rd, Rd, Rd, Rd, Ce, Rd, Rd, Rd, Rd, Rd, Rd, Rd, Rd, Rd, Re, Rd, Rd, Rd, Re, Rd, Hhd, Rd, Ww, Gs^Fds, Gs^Fds, Gll, Gs^Fds, Gs^Fds, Gs^Fds, Gll, Gs^Fds, Gs^Fds
Rd, Rd, Rd, Ce, 1 Ke, Ce, Re, Re, Re^Vct, Rd, Re, Rd, Re, Re, Rd, Rd, Re^Vct, Re, Re, Rd, Ds, Ww, Gs^Fds, Gs^Fds, Hhd, Gs^Fds, Hhd^Fds, Gll^Fmf, Hhd^Fmf, Gs^Fds, Gs^Fmf, Gs^Fds
Rd, Rd, Rd, Ce, Ce, Ce, Re, Re, Re, Rd, Re, Re, Re, Rd, Rd, Rd, Re, Rd, Ket, Rd, Ww, Ww, Gs^Fds, Gs^Fds, Gll^Fmf, Hhd^Fds, Gll, Gll^Fmf, Gs^Fds, Gs^Fds, Gs^Fds, Gs^Fds
Rd, Rd, Rd, Ce, Rb, Ce, Rd, Rd, Rd, Re, Re, Re, Rd, Hhd, Re^Vct, Rd, Rd^Bp|, Rd, Ww^Bw\, Ww, Re, Re, Gll^Fdw, Gs^Fds, Gs^Fmf, Gll, Gll, Gll^Fmf, Gll^Fmf, Gs^Fds, Gs^Fds, Gs^Fds
Rd, Re^Vct, Rd, Rd, Hhd, Rd, Rd, Rd, Rd, Rd, Rd, Re, Rd, Ds^Ecf, Rd, Rd^Bp|, Re^Bp|, Ket, Wwt^Bh|, Rb, Re, Re^Edt, Re^Edt, Gs^Fds, Gs^Fms, Gs^Fds, Gs^Fms, Gs^Fds, Gs^Fms, Gll^Fmf, Gs^Fds, Gll^Fmf
Rd, Rd, Rd, Re, Re, Re, Hhd, Rd, Re^Vct, Rd, Ds^Ecf, Rd, Rd, Rd, Rd, Re^Bp|, Re^Bp|, Ket, Ww, Rb, Re, Ds^Ecf, Gll^Edt, Gs^Fds, Gs^Fds, Gll^Fmf, Gll, Gs^Fds, Gll^Fmf, Gs^Fds, Gs^Fds, Gs^Fds
Rd, Rd, Rd, Re^Vct, Rd, Re, Rd, Re, Rd, Rd, Rd, Rd, Re^Vct, Re, Hhd, Hhd, Wwt, Rb, Ww, Gll^Edt, Gll^Edt, Gll^Edt, Gs^Fds, Gs^Fds, Gg^Ve, Gs^Fds, Gs^Fds, Hhd, Gs^Fds, Hhd, Gs^Fds, Gs^Fds
Rd, Rd, Rd, Rd, Rd, Rd, Rd, Rd, Rd, Rd, Rd, Rd, Ket, Ket, Ww, Ww, Gll, Ww, Hhd^Fms, Gs^Fds, Gs^Fds, Gll^Fmf, Gs^Fmf, Gs^Fds, Gll^Fmf, Gs^Fds, Gs^Fds, Gs^Fds, Hhd^Fmf, Gs^Fds, Gs^Fds, Gg
Rd, Rd, Wwf^Es, Rd, Ds, Ds, Ds, Re^Vct, Ww, Rd, Ket, Rd, Wwt^Bp\, Ww, Ww, Re, Gll^Edt, Gll^Fmf, Gll^Fmf, Gs^Fds, Gll^Fmf, Gll^Fmf, Gs^Fds, Gs^Fmf, Gs^Fds, Gs^Fds, Gll^Fmf, Hhd^Fds, Hhd^Fds, Hhd^Fds, Gs^Fmf, Gg
Wwt, Wwf^Es, Wwf^Es, Re^Vct, Ww, Ww, Ww, Ww, Ds, Ww, Ww, Ww, Wwf^Es, Wwt^Bp\, Re, Re, Gll^Edt, Gll^Edt, Gll^Fmf, Gs^Fds, Gs^Fds, Gll^Fmf, Gll^Fmf, Gll, Gs^Fds, Gs^Fds, Gs^Fds, Gs^Fds, Gs^Fds, Hhd^Fds, Gs^Fds, Gg
Wwt, Wwf^Es, Uu, Ww, Mm, Hh, Hh, Gg, Gg^Ve, Gg, Gg, Gs^Fds, Ww, Ww, Re, Ds^Ecf, Gll^Edt, Gll^Fmf, Gs^Fds, Gs^Fds, Gs^Fds, Gs^Fms, Hhd, Gs^Fds, Gs^Fds, Gs^Fds, Gg^Ve, Gs^Fds, Gs^Fds, Gll^Fmf, Gs^Fds, Gg
Wwt, Hh, Mm, Uu, Uu, Hh, Gg, Mm, Hh, Gs^Fds, Hh, Ww, Ww, Ww, Gll, Gll^Edt, Gs^Fds, Gll^Fmf, Gs^Fds, Gs^Fds, Gs^Fds, Gll^Fmf, Gll^Fmf, Hh^Fds, Gs^Fds, Gs^Fds, Gs^Fds, Gs^Fds, Gs^Fds, Gs^Fds, Gs^Fds, Gs^Fds
Ww, Gg^Ve, Hh, Mm, Gs^Fds, Rb, Gs^Fds, Hh^Fds, Gs^Fds, Gg, Wwt, Ww, Ww, Gll^Edt, Gs^Fds, Hhd^Fds, Gs^Fmf, Gs^Fds, Gs^Fds, Gg^Ve, Gs^Fds, Gs^Fds, Gll^Fmf, Gll^Fmf, Gll^Fmf, Gll^Fmf, Gs^Fds, Gs^Fds, Gs^Fmf, Gs^Fds, Gs^Fds, Gs^Fds
Ww, Ww, Ww, Hh^Fds, Gs^Fds, Hh, Wwf^Es, Gg, Ww, Ww, Ww, Ww, Gs^Fds, Gs^Fds, Hhd^Fds, Gll^Fmf, Gs^Fmf, Gs^Fms, Gll^Fmf, Gs^Fds, Hhd, Gll^Fmf, Gs^Fds, Hhd^Fds, Hhd^Fmf, Gs^Fds, Gs^Fds, Gll^Fmf, Gs^Fds, Gll^Fmf, Gs^Fds, Gs^Fds
Gs^Fds, Gs^Fds, Gs^Fds, Ww, Ww, Ww, Ww, Ww, Wwf^Es, Ww, Gs^Fms, Gs^Fds, Gll, Gs^Fds, Gs^Fds, Gll^Fmf, Gs^Fms, Gs^Fds, Gs^Fds, Gs^Fms, Gs^Fds, Gs^Fds, Hh^Fds, Gs^Fds, Gs^Fds, Gll^Fmf, Gs^Fds, Gs^Fds, Gs^Fds, Gs^Fds, Gs^Fds, Gs^Fds
Gs^Fds, Gll, Gs^Fds, Gll, Gll, Ww, Wwf^Es, Wwf^Es, Gs^Fds, Gs^Fds, Gs^Fds, Gs^Fds, Gll, Gs^Fms, Gll^Fmf, Gs^Fds, Gs^Fmf, Hhd^Fds, Hhd^Fds, Gs^Fms, Gll^Fmf, Gs^Fds, Hhd^Fds, Gs^Fds, Gll^Fmf, Gs^Fds, Gs^Fds, Gg^Ve, Gs^Fds, Gll^Fmf, Gs^Fds, Gs^Fds
Gs^Fds, Gs^Fds, Hhd^Fmf, Gs^Fds, Gs^Fds, Gg, Gs^Fds, Gs^Fds, Gs^Fds, Gll, Gll^Fmf, Gs^Fds, Gs^Fmf, Gs^Fds, Gs^Fds, Gs^Fds, Gs^Fds, Hhd^Fds, Gll^Fmf, Gs^Fds, Gs^Fds, Gs^Fms, Hh^Fds, Gs^Fds, Gs^Fms, Gs^Fds, Gs^Fds, Gs^Fds, Gs^Fds, Gs^Fds, Gll^Fmf, Gs^Fds
Gs^Fds, Gll^Fmf, Gs^Fds, Gs^Fds, Gll, Gs^Fds, Gll^Fmf, Gs^Fds, Gll^Fmf, Gs^Fds, Gs^Fds, Gs^Fms, Gs^Fds, Gll^Fmf, Gs^Fds, Gs^Fds, Gs^Fmf, Gs^Fds, Gs^Fms, Hhd^Fds, Gs^Fms, Hhd^Fds, Gs^Fms, Gs^Fds, Gs^Fds, Gs^Fds, Gs^Fds, Gs^Fds, Gs^Fds, Gs^Fds, Gs^Fds, Gs^Fds
Gs^Fds, Gs^Fds, Gs^Fds, Gll^Fmf, Hhd^Fds, Gs^Fms, Gs^Fds, Hhd^Fms, Gs^Fms, Gs^Fms, Gll, Gll^Fmf, Gll^Fmf, Gs^Fds, Gs^Fds, Gg^Ve, Gs^Fds, Gs^Fds, Gs^Fms, Gs^Fds, Gll^Fmf, Gs^Fms, Gs^Fds, Gs^Fms, Gll^Fmf, Gs^Fds, Cv, Cv, Cv, Gs^Fds, Gs^Fds, Gs^Fds
Gs^Fds, Gll^Fmf, Gs^Fds, Gll^Fmf, Gll^Fmf, Gll^Fmf, Gs^Fds, Gs^Fds, Gs^Fds, Gll, Gs^Fds, Gs^Fms, Gs^Fds, Gs^Fds, Gll^Fmf, Gs^Fds, Gs^Fds, Gs^Fms, Gll^Fmf, Gs^Fds, Gs^Fds, Gs^Fds, Gs^Fds, Gs^Fds, Gs^Fds, Gs^Fds, Cv, 2 Kv, Cv, Gs^Fds, Gll^Fmf, Gs^Fds
Gs^Fds, Gs^Fds, Gs^Fds, Gll^Fmf, Gs^Fds, Gll, Gs^Fds, Hhd^Fmf, Gs^Fds, Gll^Fmf, Gs^Fds, Gll^Fmf, Gs^Fds, Gs^Fms, Gs^Fds, Gs^Fds, Gs^Fds, Gs^Fmf, Gs^Fds, Gs^Fds, Gs^Fds, Gs^Fmf, Gg^Ve, Gs^Fds, Gs^Fds, Gs^Fds, Gs^Fds, Cv, Gs^Fds, Gs^Fds, Gs^Fds, Gs^Fds
Gs^Fds, Gs^Fds, Gs^Fds, Gll^Fmf, Gs^Fms, Gs^Fms, Gs^Fds, Gll^Fmf, Gs^Fds, Gs^Fds, Gs^Fms, Gs^Fms, Hhd^Fds, Gs^Fds, Gs^Fds, Gll^Fmf, Gs^Fds, Gs^Fmf, Gs^Fds, Gll^Fmf, Gs^Fms, Gs^Fds, Gs^Fds, Gs^Fds, Gs^Fds, Gll^Fmf, Gs^Fds, Gs^Fds, Gs^Fds, Gs^Fds, Gs^Fds, Gs^Fds
Gs^Fds, Gs^Fds, Gs^Fds, Gs^Fds, Gs^Fds, Gs^Fds, Gs^Fds, Gs^Fds, Gs^Fds, Gs^Fms, Gs^Fds, Gs^Fds, Gs^Fds, Gs^Fds, Gs^Fds, Gs^Fds, Gs^Fds, Gs^Fds, Gs^Fds, Gs^Fms, Gs^Fms, Gs^Fds, Gs^Fds, Gs^Fds, Gs^Fds, Gs^Fds, Gs^Fds, Gs^Fds, Gs^Fds, Gll^Fmf, Gs^Fds, Gs^Fds
