border_size=1
usage=map

Gg, Gg, Gg, Gg, Gg, Gg, Gg, Gg, Gg, Gg, Gg, Gg, Gg, Gg, Gg, Gg, Gg, Gg, Gg, Gg, Gg, Gg, Gg, Gg, Gg, Gg
Gg, Gg, Gg, Gg, Gg, Gg, Gg, Gg, Gg, Gg, Gg, Gg, Gg, Gg, Gg, Gg, Gg, Gg, Gg, Gg, Gg, Gg, Gg, Gg, Gg, Gg
Gg, Gs, Gd^Vo, Gg, Gs, Gg, Gs, Gg, Gs, Gg, Gs, Gs, Gs, Gs, Gs, Gg, Gs, Gg, Gs, Gs, Gs, Gs^Vc, Gg, Gg, Gg, Gg
Gg, Gg, Gg, Gs, Gg, Gs, Gg, Gs, Gg, Gs, Gg, Gg, Gg, Gg, Gg, Gg, Gg, Gg, Gg, Gg, Gg, Gg, Gg, Gs, Gg, Gg
Gg, Gg, Gg, Gg, Gg, Gg, Gg, Gg, Rb, Gg, Gg, Gg, Gg, Gg, Gg, Gg, Gg, Gg, Co, Gg, Gg, Gg, Gg, Gd^Vo, Gg, Gg
Gg, Gg, Gg, Gg, Gg, Gg, Gg, Rb, Gg, Rb, Rb, Gs^Vc, Gg, Gg, Gg, Gg, Co, Co, Ke, Co, Gg, Gg, Gg, Gg, Gg, Gs
Gg, Gg, Gg, Gg, Gg, Gg, Gs^Vc, Rb, Gg, Gg, Gg, Gg, Gg, Gg, Gg, Gg, Co, Co, Co, Co, Gg, Gg, Gg, Gg, Gg, Gs
Gs, Gg, Gs, Gg, Gg, Gg, Gg, Gg, Gg, Gg, Gg, Gg, Gg, Gg, Gg, Gg, Gg, Co, Gg, Rb, Gg, Gg, Gg, Gg, Gg, Gg
Gg, Gs, Gs, Gs, Gg, Gg, Gg, Gg, Gg, Gg, Gg, Gg, Gg, Gg, Gg, Gg, Gg, Gg, Gg, Rb, Gg, Gg, Gs, Gg, Gg, Gg
Gg, Gg, Gg, Gs, Gs, Gg, Gg, Gg, Gg, Gg, Gg, Gg, Gs, Gg, Gg, Gg, Gg, Gg, Gs, Rb, Gs, Gs, Gs, Gs, Gg, Gg
Gg, Gg, Gg, Gg, Gg, Gs, Gs, Gs, Gs, Gs, Gs, Gs, Gd^Vo, Gs, Gs, Gs, Gs, Gs, Gg, Rb, Gg, Gs, Gs, Gg, Gg, Gg
Gg, Gg, Gg, Gg, Gg, Gg, Gg, Gg, Gg, Gg, Gg, Gg, Gg, Gg, Gg, Gg, Gg, Gg, Gg, Rb, Gg, Gg, Gg, Gg, Gg, Gg
Gg, Gg, Gg, Gg, Gg, Gg, Gg, Gg, Gg, Gg, Gg, Gg, Gg, Gg, Gg, Gg, Gg, Gg, Gg, Rb, Gg, Gg, 2 Gs, Gg, Gg, Gg
Gg, Gg, Gg, Gs, Gg, Gg, Gg, Gg, Gg, Gg, Ce, Gg, Gg, Gg, Gg, Gg, Gs^Vc, Gg, Gg, Rb, Gg, Gs, Gg^Ecf, Gs, Gg, Gg
Gg, Gg, Gg, Gs, Gg, Gg, Gg, Gg, Ce, Ce, Ce, Ce, Gg, Gg, Gg, Gg, Gs, Rb, Rb, Rb, Gg, Gs, Gs, Gs, Gg, Gg
Gg, Gg, Gg, Gs, Gg, Gg, Gg, Ce, Ce, Ce, Ce, Ce, Gg, Gg, Gg, Gg, Gg, Gs, Gg, Rb, Gg, Gg, Gg, Gg, Gg, Gg
Gg, Gg, Gg, Gs, Gs^Vc, Gg, Gg, Ce, 1 Ke, Ce, Ce, Ce, Gg, Gg, Gg, Gg, Gg, Gg, Gg, Rb, Gg, Gg, Gg, Gg, Gg, Gg
Gg, Gg, Gg, Gg, Gg, Gg, Gg, Gg, Gg, Ce, Gg, Gg, Gg, Gg, Gg, Gg, Gg, Gg, Gg, Rb, Gg, Gg, Gs, Gg, Gg, Gg
Gg, Gg, Gs, Gg, Gs^Vc, Gg, Gg, Gg, Gg, Gg, Gs, Gg, Gd^Vo, Gg, Gs, Gg, Gs, Gg, Gs, Rb, Rb, Gs, Gs^Ecf, Gs, Gg, Gg
Gg, Gs, Gg, Gs, Gs, Gs, Gs, Gs, Gs, Gs, Gg, Gs, Gg, Gs, Gg, Gs, Gg, Gg, Gg, Gs, Gg, Rb, Rb, Gs, Gg, Gg
Gg, Gg, Gg, Gg, Gg, Gg, Gg, Gg, Gg, Gg, Gg, Gg, Gg, Gg, Gg, Gg, Gg, Gg, Gg, Gg, Gg, Gg, Gg, Rb, Rb, Gg
Gg, Gg, Gg, Gg, Gg, Gg, Gg, Gg, Gg, Gg, Gg, Gg, Gg, Gg, Gg, Gg, Gg, Gg, Gg, Gg, Gg, Gg, Gg, Gg, Gg, Gg
